45 20
20 7 7 7 7 7 7 7 7 7 7 7 7 7 7 7 7 7 7 7 7 7 7 7 24 25 7 7 7 7 7 24 25 7 7 7 7 7 7 7 7 7 7 7 7
20 7 7 7 7 7 7 7 7 7 7 7 7 7 7 7 7 7 7 7 7 7 7 7 36 37 7 7 7 7 7 36 37 7 7 7 7 7 7 7 7 7 7 7 7
20 7 7 7 7 7 7 7 7 7 7 7 7 7 7 7 7 7 7 7 7 7 7 7 36 37 7 7 7 7 7 36 37 7 7 7 7 7 7 7 7 7 7 7 7
20 7 7 7 7 7 7 7 7 7 7 7 7 7 7 7 7 7 7 7 7 7 7 7 7 7 7 7 7 7 7 7 7 7 7 7 7 7 7 7 7 7 7 7 7
20 7 7 7 7 7 7 7 7 7 7 7 7 7 7 7 7 7 7 7 7 7 7 7 7 7 7 7 7 7 7 7 7 7 7 7 7 7 7 7 7 7 7 7 7
20 7 7 7 7 7 7 7 7 7 7 7 7 7 7 7 7 7 7 7 7 7 7 7 7 7 7 7 7 7 7 7 7 7 7 7 7 7 7 7 7 7 7 7 7
20 7 7 7 7 7 7 7 7 7 7 7 7 7 7 4 5 23 7 7 7 7 7 7 36 37 7 7 7 7 7 36 37 7 7 7 7 22 22 22 22 22 22 22 22
20 7 7 7 7 7 7 7 7 7 7 7 7 4 5 7 7 7 7 7 7 7 7 7 36 37 7 7 7 7 7 36 37 7 7 7 7 7 7 7 7 7 7 7 7
20 7 7 7 7 7 7 7 7 7 4 5 7 7 7 7 7 7 7 7 7 7 7 7 24 25 6 6 6 6 6 24 25 7 7 7 7 7 7 7 7 7 7 7 7
20 6 6 20 6 7 22 10 23 7 7 7 7 7 7 7 7 7 7 7 7 7 7 7 7 7 7 7 7 7 7 36 37 7 7 7 7 7 7 7 7 7 7 7 7
21 10 10 23 6 7 7 7 7 7 7 7 7 7 7 7 7 7 7 7 7 7 7 7 7 7 7 7 7 7 7 36 37 7 7 7 7 33 33 33 33 33 33 33 33
7 7 7 7 7 7 7 7 7 7 7 7 7 7 7 7 7 7 7 7 7 7 7 7 7 7 7 7 7 7 7 36 37 7 7 7 7 33 7 7 7 7 7 7 33
7 7 7 7 7 7 7 7 7 7 7 20 7 7 7 7 7 7 7 7 7 7 7 7 7 7 7 7 7 7 7 36 37 7 7 7 7 33 7 7 7 7 7 7 33
7 7 7 7 7 7 7 7 7 7 7 20 7 7 7 7 7 7 7 7 7 7 7 7 7 7 7 7 7 7 7 36 37 7 7 7 7 33 7 7 7 7 7 7 33
7 7 7 7 7 7 7 7 7 7 7 20 7 7 7 7 7 7 7 7 7 7 7 7 9 10 11 7 4 5 7 46 46 46 46 46 46 33 7 7 7 7 7 7 33
7 7 7 7 7 7 7 7 7 7 7 20 7 7 7 7 7 7 7 7 7 7 7 7 14 7 14 7 7 7 7 7 7 7 7 7 7 7 7 7 7 7 7 7 33
7 7 7 7 7 7 7 7 7 7 7 20 7 7 7 7 7 7 7 7 7 7 7 7 14 7 14 7 7 7 7 7 7 7 7 7 7 7 7 7 7 7 7 7 33
7 7 7 7 7 7 7 7 7 7 7 20 7 7 7 7 7 7 7 7 7 7 7 7 14 7 14 7 7 7 46 46 7 7 46 46 46 33 7 7 7 7 7 7 33
10 10 10 10 10 7 10 10 7 10 5 8 4 10 11 7 9 22 22 7 7 7 10 10 23 7 14 7 7 7 52 52 46 46 46 53 52 33 6 6 6 6 6 6 33
7 7 7 7 7 7 7 7 7 7 7 14 7 7 14 7 14 7 7 7 7 7 7 7 7 7 14 7 7 7 52 52 53 52 52 52 53 33 33 33 33 33 33 33 33