17 12
7 7 7 7 7 7 7 7 7 7 7 7 7 7 7 7 7
7 7 7 7 7 7 7 7 7 7 7 7 7 7 7 7 7
7 7 7 7 7 7 7 7 7 7 7 7 7 7 7 7 7
7 7 7 7 7 7 7 7 7 7 7 7 7 7 7 7 7
7 7 7 7 7 7 7 7 7 26 27 27 27 28 7 7 7
7 7 7 7 7 7 7 7 7 41 26 27 29 35 7 7 7
7 7 7 7 7 7 7 7 7 41 32 33 35 35 7 7 7
7 7 7 7 7 7 7 7 7 41 38 39 40 35 7 7 7
7 7 7 7 7 7 7 7 7 38 39 39 39 40 7 7 7
7 7 7 7 7 7 7 7 7 7 7 7 7 7 7 7 7
7 7 7 7 7 7 7 7 7 7 7 7 7 7 7 7 7
7 7 7 7 7 7 7 7 7 7 7 7 7 7 7 7 7